50, 750, 0; 83, 750, 1; 116, 750, 1; 269, 750, 1; 302, 750, 1; 335, 750, 0;
149, 767, 4; 236, 767, 4;
50, 784, 0; 83, 784, 1; 116, 784, 1; 269, 784, 1; 302, 784, 1; 335, 784, 0;
149, 801, 4; 236, 801, 4;
176, 818, 4; 209, 818, 4;   
50, 835, 0; 83, 835, 1; 116, 835, 1; 149, 835, 4; 236, 835, 4; 269, 835, 1; 302, 835, 1; 335, 835, 0;
50, 852, 0; 176, 852, 4; 209, 852, 4; 335, 852, 0;
83, 869, 1; 116, 869, 1; 149, 869, 4; 236, 869, 4; 269, 869, 1; 302, 869, 1;
50, 940, 0; 83, 940, 0; 302, 940, 0; 335, 940, 0;
50, 957, 5; 335, 957, 5;
50, 974, 6; 83, 974, 6; 302, 974, 6; 335, 974, 6;

45, 400, 5; 78,400, 4; 111, 400, 4; 144, 400, 5; 177, 400, 4; 210, 400, 4; 243, 400, 5; 276,400,4; 309,400,4; 342,400,5;
45, 432, 4; 144, 432, 4 ; 243, 432, 4; 342, 432,4;
78 , 449, 5; 111, 449, 5 ; 276, 449, 5; 309, 449, 5;
78, 466,2 ; 111, 466, 2 ; 177, 466, 5; 210, 466, 5; 276,466, 2 ; 309,466,2;
45, 483, 5; 111, 483,2 ; 177, 483, 4; 210, 483, 4; 276,483, 2 ; 309,483,2;
45, 500, 5; 111, 500,2 ; 177, 500, 4; 210, 500, 4; 276,500, 2 ; 309,500,2;
78 , 517, 8; 111, 517, 8 ; 276, 517, 8; 309, 517, 8;
78 , 534, 4; 111, 534, 4 ; 276, 534, 4; 309, 534, 4;
78 , 551, 5; 111, 551, 5 ; 276, 551, 5; 309, 551, 5;

144, 17, 6; 177, 17, 6; 210, 17, 6; 243, 17, 6;
144, 34, 2; 177, 34, 2; 210, 34, 2; 243, 34, 2;
45, 51, 4 ; 78, 51, 4 ; 111, 51 , 4; 276, 51, 4; 309, 51 , 4; 342,51, 4;
114, 128, 2; 177, 128, 2; 210, 128, 2; 272, 128, 2;
114, 145, 0; 177, 145, 0; 210, 145, 0; 272, 145, 0;
78, 178, 4 ; 309, 178 , 4;
45, 195, 4 ; 78, 195, 4 ; 309, 195 , 4; 342, 195, 4;