61, 720, 0; 176, 720 , 0 ; 207, 720 , 0 ; 324, 720, 0 ;
61, 738, 0; 324, 738, 0 ;
30, 756, 0; 61, 756, 0; 324, 756, 0 ; 355, 756, 0; 
176, 800 , 3 ; 207, 800 , 3 ;
30, 818, 6 ; 145, 818, 3; 238, 818, 3;
30, 836, 6 ; 114, 836, 3; 145, 836, 6; 238, 836, 6;  269, 836, 3;
30, 854, 6 ; 83 , 854, 3; 114, 854, 7; 145, 854, 6; 238, 854, 6; 269, 854, 7; 300, 854, 3; 
83 , 872, 3; 114, 872, 7; 145, 872, 6; 176, 872, 6 ; 207, 872, 6 ; 238, 872, 6; 269, 872, 7; 300, 872, 3; 355, 872, 6; 
114, 890, 3; 145, 890, 7; 176, 890, 7 ; 207, 890, 7 ; 238, 890, 7; 269, 890, 3; 355, 890, 6;
145, 908, 3; 176, 908, 7 ; 207, 908, 7 ; 238, 908, 3; 355, 908, 6; 
176, 926, 7 ; 207, 926, 7 ; 

30, 380, 1; 61, 380, 2; 117, 380, 1; 148, 380, 5; 179, 380, 5; 210, 380, 5; 241, 380, 5; 272, 380, 1; 324, 380, 2 ; 355, 380, 1;
30, 398, 1; 117, 398, 5; 148, 398, 4; 179, 398, 4; 210, 398, 4; 241, 398, 4; 272, 398, 5; 355, 398, 1;
61, 416, 2; 117, 416, 1; 272, 416, 1; 324, 416, 2 ;
117, 434, 1; 272, 434, 1; 148, 434, 4; 179, 434, 4; 210, 434, 4; 241, 434, 4;
30, 452, 1; 61, 452, 2; 324, 452, 2 ; 355, 452, 1;
30, 470, 1; 61, 470, 2; 117, 470, 1; 148, 470, 5; 179, 470, 5; 210, 470, 5; 241, 470, 5; 272, 470, 1; 324, 470, 2 ; 355, 470, 1;
30, 488, 1; 61, 488, 2; 324, 488, 2 ; 355, 488, 1;
30, 506, 1; 61, 506, 2; 117, 506, 1; 148, 506, 5; 179, 506, 5; 210, 506, 5; 241, 506, 5; 272, 506, 1; 324, 506, 2 ; 355, 506, 1;
61, 524, 2; 117, 524, 1; 148, 524, 5; 241, 524, 5; 272, 524, 1; 324, 524, 2 ; 
19, 635, 3; 50, 635, 5; 82, 635, 3; 305, 635, 3; 337, 635, 5; 368, 635, 3;
50, 653, 3; 337, 653, 3;

54, 45, 6 ; 85, 45, 6 ; 116, 45, 4; 147, 45, 4; 178, 45, 4; 209, 45, 4; 240, 45, 4; 271, 45, 4 ; 302, 45, 6 ; 333, 45, 6;
54, 63, 6; 85, 63, 6 ; 116, 63, 4; 147, 63, 3; 178, 63, 3; 209, 63, 3; 240, 63, 3; 271, 63, 4 ; 302, 63, 6 ; 333, 63, 6;
54, 102, 6 ; 85, 102, 6 ; 178, 102, 6; 209, 102, 6; 302, 102, 6 ; 333, 102, 6;
116, 117, 6; 271, 117, 6 ;
116, 135, 6; 271, 135, 6 ;
54, 148, 6 ; 85, 148, 6 ; 178, 148, 6; 209, 148, 6; 302, 148, 6 ; 333, 148, 6;
147, 192, 6; 178, 192, 3; 209, 192, 6; 240, 192, 3;
147, 210, 3; 178, 210, 6; 209, 210, 3; 240, 210, 6;