34, 748, 0; 352, 748, 0;
34, 765, 4; 352, 765, 4;
34, 782, 0; 352, 782, 0;
101, 799, 0; 132, 799, 0; 163, 799, 0; 194, 799, 0; 225, 799, 0; 256, 799, 0; 287, 799, 0;
101, 817, 3; 132, 817, 3; 163, 817, 3; 194, 817, 3; 225, 817, 3; 256, 817, 3; 287, 817, 3;
101, 835, 3; 132, 835, 4; 163, 835, 3; 194, 835, 4; 225, 835, 3; 256, 835, 4; 287, 835, 3;
101, 853, 4; 132, 853, 4; 163, 853, 4; 194, 853, 4; 225, 853, 4; 256, 853, 4; 287, 853, 4; 
101, 871, 3; 132, 871, 4; 163, 871, 3; 194, 871, 4; 225, 871, 3; 256, 871, 4; 287, 871, 3;
101, 889,3; 132, 889,3; 163, 889,3; 194, 889,3; 225, 889,3; 256, 889,3; 287, 889,3;

117, 380, 7; 148, 380, 5; 179, 380, 7; 210, 380, 5; 241, 380, 7; 272, 380, 5;
117, 398, 5; 148, 398, 7; 179, 398, 5; 210, 398, 7; 241, 398, 5; 272, 398, 7;
148, 449, 7; 179, 449, 7; 210, 449, 7; 241, 449, 7;
148, 467, 5; 179, 467, 5; 210, 467, 5; 241, 467, 5;
51, 484, 5; 83, 484, 3; 305, 484, 3; 337, 484, 5;
148, 500, 1; 179, 500, 1; 210, 500, 1; 241, 500, 1;
179, 518, 1; 210, 518, 1; 241, 518, 3;
241, 536, 3;
148, 554, 1; 241, 554, 3;
50, 650, 5; 82, 650, 3; 305, 650, 3; 337, 650, 5;

147, 17, 3; 178, 17, 3; 209, 17, 3; 240, 17, 3;
54, 34, 7 ; 85, 34, 3 ; 116, 34, 4; 271, 34, 4 ; 302, 34, 3 ; 333, 34, 7;
85, 52, 3 ; 302, 52, 3;
85, 70, 3 ; 302, 70, 7;
85, 88, 3 ; 116, 88, 3; 147, 88, 3; 178, 88, 7; 209, 88, 7; 240, 88, 3; 271, 88, 3; 302, 88, 7;
85, 106, 7 ; 302, 106, 7;
85, 124, 7 ; 116, 124, 6 ; 271, 124, 6; 302, 124, 7;
54, 142, 6 ; 85, 142, 7 ; 302, 142, 6; 333, 142, 7; 
85, 160, 7 ; 116, 160, 6 ; 178, 160, 3; 209, 160, 3; 271, 160, 6; 302, 160, 7;
85, 178, 7 ; 302, 178, 7;
85, 196, 3 ; 116, 196, 6 ; 147, 196, 6; 240, 196, 6; 271, 196, 6; 302, 196, 3;
85, 214, 3 ; 302, 214, 3;
85, 232, 7 ; 116, 232, 6 ; 271, 232, 6; 302, 232, 7;
