TILEMAP
26 65 							-- Size of tile map in tiles
16 32 							-- Tile size & block size
images/test.png 	-- Tilesheet
2 2 								-- Number of tiles in tilesheet
11111111111111111111111111
12222222222222222222222221
12222222222222222222222221
12222222222222222222222221
12222222222222222222222221
12222222222222222222222221
12222222222222222222222221
12222222222222222222222221
12222222222222222222222221
12222222222222222222222221
12222222222222222222222221
12222222222222222222222221
12222222222222222222222221
12222222222222222222222221
12222222222222222222222221
12222222222222222222222221
12222222222222222222222221
12222222222222222222222221
12222222222222222222222221
12222222222222222222222221
111111111        111111111
33333333333333333333333333
111111111        111111111
12222222222222222222222221
12222222222222222222222221
12222222222222222222222221
12222222222222222222222221
12222222222222222222222221
12222222222222222222222221
12222222222222222222222221
12222222222222222222222221
12222222222222222222222221
12222222222222222222222221
12222222222222222222222221
12222222222222222222222221
12222222222222222222222221
12222222222222222222222221
12222222222222222222222221
12222222222222222222222221
12222222222222222222222221
12222222222222222222222221
12222222222222222222222221
111111111        111111111
33333333333333333333333333
111111111        111111111
12222222222222222222222221
12222222222222222222222221
12222222222222222222222221
12222222222222222222222221
12222222222222222222222221
12222222222222222222222221
12222222222222222222222221
12222222222222222222222221
12222222222222222222222221
12222222222222222222222221
12222222222222222222222221
12222222222222222222222221
12222222222222222222222221
12222222222222222222222221
12222222222222222222222221
12222222222222222222222221
12222222222222222222222221
12222222222222222222222221
12222222222222222222222221
111111111        111111111