TILEMAP
26 65 							-- Size of tile map in tiles
16 32 							-- Tile size & block size
images/tiles3.png 	-- Tilesheet
2 2 								-- Number of tiles in tilesheet
11111111111111111111111111
12222222222222222222222221
12222222222222222222222221
12222222222222222222222221
12222222222222222222222221
12222222222222222222222221
12222222222222222222222221
12222222222222222222222221
12222222222222222222222221
12222222222222222222222221
12222222222222222222222221
12222222222222222222222221
12222222222222222222222221
12222222222222222222222221
12222222222222222222222221
12222222222222222222222221
12222222222222222222222221
12222222222222222222222221
12222222222222222222222221
12222222222222222222222221
1111111            1111111
33333333333333333333333333
111111111        111111111
12222222222222222222222221
12222222222222222222222221
12222222222222222222222221
12222222222222222222222221
12222222222222222222222221
12222222222222222222222221
12222222222222222222222221
12222222222222222222222221
12222222222222222222222221
12222222222222222222222221
12222222222222222222222221
12222222222222222222222221
12222222222222222222222221
12222222222222222222222221
12222222222222222222222221
12222222222222222222222221
12222222222222222222222221
12222222222222222222222221
12222222222222222222222221
1  11                11  1
33333333333333333333333333
111111111        111111111
12222222222222222222222221
12222222222222222222222221
12222222222222222222222221
12222222222222222222222221
12222222222222222222222221
12222222222222222222222221
12222222222222222222222221
12222222222222222222222221
12222222222222222222222221
12222222222222222222222221
12222222222222222222222221
12222222222222222222222221
12222222222222222222222221
12222222222222222222222221
12222222222222222222222221
12222222222222222222222221
12222222222222222222222221
12222222222222222222222221
12222222222222222222222221
11111                11111